Akiba's Trip: Undead and Undressed | Akiba's Trip: Undead & Undressed
Arcana Heart 3: Love Max!!! | Arcana Heart 3: LOVE MAX!!!!!
Atari Flashback Classics Vol 1 | Atari Flashback Classics vol.1
Atari Flashback Classics Vol 2 | Atari Flashback Classics vol.2
Atelier Escha & LOGY - ALCHEMISTS OF THE DUST SKY | Atelier Escha & Logy: The Alchemists of Dusk Sky
Azkend 2 | Azkend 2: The World Beneath
Batman: Arkam Asylum Game of the Year | Batman: Arkham Asylum
BloodRayne: Betryal | BloodRayne: Betrayal
Brave | Disney Pixar's Brave: The Video Game
Burn Zombie Burn: The Diarrhea Bundle | Burn Zombie Burn!
Cities: Skylines | Cities: Skylines - PlayStation 4 Edition
Comet Crash Bionic Bundle | Comet Crash
Cuboid Ultimate Bundle | Cuboid
Disney Epic Mickey 2: The Power of Two | Epic Mickey 2: The Power of Two
Earth Defense Force: Insect Armaggedon | Earth Defense Force: Insect Armageddon
F.E.A.R. FIRST ENCOUNTER ASSAULT RECON | F.E.A.R.
Giana Sisters: Twisted Dreams | Giana Sisters: Twisted Dreams - Director's Cut
God of War® HD | God of War
God of War® II HD | God of War II
God of War: Ghosts of Sparta | God of War: Ghost of Sparta
Grim Fandango Remastered | Grim Fandango
Guacamelee! Bundle Fantástico | Guacamelee!
HITMAN 2 | Hitman 2 (2018)
ICO™ Classics HD | Team Ico Collection: ICO
Injustice: Gods Among Us Ultimate Edition | Injustice: Gods Among Us
LEGO Indiana Jones: The Adventure Continues | LEGO Indiana Jones 2: The Adventure Continues
Last Tinker: City of Colors | The Last Tinker: City of Colors
Lost Planet: Extreme Edition | Lost Planet: Extreme Condition
Mafia III | Mafia III: Definitive Edition
Metal Gear Rising Revengeance Ultimate Edition | Metal Gear Rising: Revengeance
Metro: Last Light – Complete Edition | Metro: Last Light
Motorstorm RC Complete Edition | Motorstorm RC
NIGHTMARES FROM THE DEEP 2: THE SIREN`S CALL | Nightmares from the Deep 2: The Siren's Call
OlliOlli | OlliOlli: Epic Combo Edition (Retail)
Penny Arcade Adventures: OTRSPOD Ep 1 | Penny Arcade Adventures: On the Rain-Slick Precipice of Darkness: Episode One
Penny Arcade Adventures: OTRSPOD Ep 2 | Penny Arcade Adventures: On the Rain-Slick Precipice of Darkness: Episode Two
Phineas and Ferb: Across the Second Dimension | Phineas and Ferb: Across the 2nd Dimension
PixelJunk Eden Encore | PixelJunk Eden
PixelJunk Nom Nom Galaxy | Nom Nom Galaxy
Port Royale 3: Gold | Port Royale 3: Pirates and Merchants
Prey | Prey (2017)
Pure Farming 18 | Pure Farming 2018
Pure Hold'em World Poker Championship | Pure Hold 'Em
Puzzle Agent | Nelson Tethers:  Puzzle Agent
Rainbow Moon | Rainbow Moon  (Retail)
Ratchet and Clank: Quest for Booty | Ratchet & Clank Future: Quest for Booty
Realms of Ancient War | RAW: Realms of Ancient War (NA & EU)
Red Faction Guerilla Re-MARS-tered | Red Faction: Guerrilla Re-Mars-tered
Red Faction: Guerilla | Red Faction: Guerrilla
Red Johson's Chronicles | Red Johnson's Chronicles
Resident Evil 5: Gold Edition | Resident Evil 5
Resident Evil Code: Veronica X HD | Resident Evil Code: Veronica X
Resident Evil Revelations 2 Complete Season | Resident Evil: Revelations 2
Resident Evil: The Darkside Chronicles HD | Resident Evil: The Darkside Chronicles
Resident Evil: The Umbrella Chronicles HD | Resident Evil: The Umbrella Chronicles
Romance of the Three Kingdoms 13 | Romance of the Three Kingdoms XIII
Runner2: Future Legend of Rhythm Alien | BIT.TRIP Presents... Runner2: Future Legend of Rhythm Alien
Sacred 3: Gold Edition | Sacred 3
Split/Second Velocity | Split/Second
Star Wars The Force Unleashed – Ultimate Sith Edition | Star Wars The Force Unleashed
Stealth Inc: A Clone in the Dark | Stealth Inc.
Street Fighter 3 Third-Strike Online Edition | Street Fighter III: 3rd Strike Online Edition
Super Stacker Party | Super Stacker
Technomancer | The Technomancer
The Golf Club 2019 Featuring PGA Tour | The Golf Club 2019
The Raven: Legacy of a Master Thief | The Raven
The Revenge of Shinobi | Revenge of Shinobi
Touhou Genso Rondo: Bullet Ballet | Touhou Genso Rondo
Toy Story Mania | Toy Story Mania!
Uncharted 3: Drake's Deception - Game of the Year Edition | Uncharted 3: Drake's Deception
WRC 4: FIA World Rally Championship | WRC 4
WRC 5: FIA World Rally Championship | WRC 5
Warhammer 40000 Inquisitor Martyr | Warhammer 40,000: Inquisitor - Martyr
Zen Pinball 2: Zen Pinball Classics | ZEN Pinball 2
